001000000000000
001000000000000
001000000011111
001000000010000
001000000010000
001000000010000
001000000010000
001000000010000
001000000010000
001000000010000
001000000010000
001000000010000
001000000010000
001000000010000
001000000010000
001000000010000
001000000010000
001001111110000
001112000000000
000000000000000