000000000000000
000000000000000
000000000000000
000100000000000
000100000000000
000100000000000
000100000111000
001100000101000
000100000101000
000100000101000
000100000101000
000100000101000
000100000101000
000100000101000
000100000101000
000100000101000
000100000101000
000100000101000
000111111102000
000000000000000