000000100001000
000000100001000
000000100001000
000000100001000
000000100001000
000111100001000
000100000001000
000100000011000
000100000010000
000100000010000
000100000010000
000100000010000
000100000010000
000100000010000
000100000010000
000100000010000
000100000010000
000100000010000
000111111120000
000000000000000