000000000000000
000000000000000
011111111111111
010000000000000
010000000000000
010000111111100
010000100000100
010000100000100
010000100000100
010000100000100
010000100000100
010000100000100
010000100000100
010000100000100
010000100000100
010000100000100
010000100000100
011111100000200
000000000000000
000000000000000