000000000000000
000000000000000
000000000011111
000000000010000
000000000010000
000000000010000
000000000010000
000000000010000
000000000010000
000000000010000
000000000010000
000000000010000
000000000010000
000000000010000
000000000010000
000000000010000
000000000010000
211111111110000
000000000000000
000000000000000